000000000000000
0CCCCCCCCCCCCC0
0CF7222222223C0
0CC100A222224C0
00C1CC1CCCG00C0
00C1001CCC100C0
00C1CC1CCC100C0
00CA228CCC100C0
00C1CC1622930C0
00C1001100010C0
00C1CC1572310C0
00C100101011CC0
00C522929245HC0
00CCCCCCCCCCCC0
000000000000000
#12.75 3.65 90
&2.5 13.5 270
@1 1
@1 1
@1 1
