0000000000000000000000000
00CCCCCCCCCCCCCCCCCCCCC00
0CF2223062306230062222HC0
00C0005280101010010000C00
0000000010105740010000000
0000000052B22922280000000
00000000C0100000010000000
0000000000100000016230000
00000C00C0100000011C10000
0000000C00A22222245740000
00000000001CCCCCCCC100000
0000C622228C00000C0100000
000001CCCC1000000C6930000
000001C00C1C00000C1C10000
0000C1C00C1000000C5740000
0C0C01CCCC1C00000C0100000
00622B22224000000C0100000
0C1CC1CCCC0C0C0C0C0100000
001C693CC62222272229H0000
0C1C1C1C01000001000000000
001C524CC1000001000000000
0C1CCCCCC1000001000000CC0
0052222229222229222222HC0
0CCCCCCCCCCCCCCCCCCCCCCC0
0000000000000000000000000
#22.75 3.65 90
&2.5 23.5


