0000000000000000000000000
0000000000000000000000000
0CC0000000000000000000000
0CF2223C00000000000000000
0CC00C1C00000000000000000
00000693C0000000000000000
000001CA27230000000000000
00000524C1C10000000000000
00000000C5740000000000000
00000000CC1C0000000000000
00000000C6930000000000000
00000000C1CA2723C00000000
00000000C52401CA272300000
00000000CCCC0524C1C100000
0000000000000000057400000
00000000000000000C1C00000
0000000000000000069300000
000000000000000001C100000
0000000000000000057400000
0000000000000000001000000
000000000000000000A230000
0000000000000000001C1CCC0
0000000000000000005292HC0
000000000000000000CCCCCC0
0000000000000000000000000
#22.75 3.65 90
&2.5 22.5 0
@1 1 0
@1 1 0
@1 1 0


