00000000000000000000000
00000000000000000000000
00CCCCC0000000000000000
00CF7272230623C62222300
00CC101CC101C524CCCC100
00CC12BCC101CC00000C100
0000CC1CC101CC00000C100
00000C1C0524CC00000C100
000CCC1C00000000000C100
0006228CC0G0622222B2400
0001CC1CC01C1CCCCC1CC00
0001CC1CC01C1C00001C000
0001CC1CC01C1C062293000
0001CC1CC01C1C01CCC1000
000522B2301C1C01CCC1000
000000101C1C1C01CCC1000
00000010A2B292292274000
000622401C1CCCCCCC1C000
0001CCC01C1C00000C1C000
00C522224C1CCCCCCC1CC00
00CCC000005222222292HC0
00000000000000000000C00
00000000000000000000000
00000000000000000000000
