000000000000000
0CCCCCCCCCCCCC0
0CF7222222223C0
0CC1006222224C0
00C1CC1CCCG00C0
00C1001CCC100C0
00C1CC1CCC100C0
00CA226CCC100C0
00C1CC1622930C0
00C1001100010C0
00C1CC1572310C0
00C100101011CC0
00C522929245HC0
00CCCCCCCCCCCC0
000000000000000
