0000000000000000000000000
0000000000000000000000000
0CC0000000000000000000000
0CF2223C00000000000000000
0CC00C1C00000000000000000
00000693C0000000000000000
000001CA27230000000000000
00000524C1C10000000000000
00000000C5740000000000000
00000000CC1C0000000000000
00000000C6930000000000000
00000000C1CA2723C00000000
00000000C52401CA272300000
00000000CCCC0524C1C100000
0000000000000000057400000
00000000000000000C1C00000
0000000000000000069300000
000000000000000001C100000
0000000000000000057400000
0000000000000000001000000
000000000000000000A230000
0000000000000000001C1CCC0
0000000000000000005292HC0
000000000000000000CCCCCC0
0000000000000000000000000
#22.75 3.65 90
&24.5 3.65 0
@19.720215 3.65 90.0
@18.311945 6.778933 182.76408
@19.295916 8.771204 179.23233
@17.337168 13.665531 91.680214
@13.344222 14.039798 177.47511
@14.783448 12.648871 449.67914
@11.647159 15.24057 391.42184
@9.804228 14.874673 546.34393
@10.29897 16.736275 540.5511
@11.640344 18.879675 369.53918
@8.441785 19.664595 451.67004
@6.620311 21.50839 360.47565
@5.3238506 22.32956 270.97134
