CCCCC000000000000000
CE7272230623C6222230
CC101CC101C524CCCC10
CC12BCC101CC00000C10
00CC1CC101CC00000C10
000C1C0524CC00000C10
0CCC1C00000000000C10
06228CC030622222B240
01CC1CC01C1CCCCC1CC0
01CC1CC01C1C00001C00
01CC1CC01C1C06229300
01CC1CC01C1C01CCC100
0522B2301C1C01CCC100
0000101C1C1C01CCC100
000010A2B29229227400
0622401C1CCCCCCC1C00
01CCC01C1C00000C1C00
C522224C1CCCCCCC1CC0
CCC000005222222292EC
000000000000000000C0
